XXXXXXXXXXX
X.       .X
XX XX XX XX
 X #   # X 
 X   Y   X 
 XXXXXXXXX 